ALA	Ala
ARG	Arg
ASN	Asn
ASP	Asp
CYS	Cys
GLN	Gln
GLU	Glu
GLY	Gly
HIS	His
ILE	Ile
LEU	Leu
LYS	Lys
MET	Met
PHE	Phe
PRO	Pro
SER	Ser
THR	Thr
TRP	Trp
TYR	Tyr
VAL	Val
